2
1 cauldron.png
2 black_block.png
20 20
2 2 2 2 2 2 2 2 2 2 2 2 2 2 2 2 2 2 2 2
2 0 2 0 0 0 0 0 0 2 0 0 0 0 0 0 0 0 0 2
2 0 2 0 2 2 2 2 0 2 0 0 0 0 0 0 0 0 0 2
2 0 2 0 0 0 0 0 2 2 0 0 0 0 1 0 0 0 0 2
2 0 0 0 2 2 2 0 0 2 0 0 0 0 0 0 0 0 0 2
2 0 2 2 2 2 2 2 0 2 0 0 0 0 0 0 0 0 0 2
2 0 2 0 0 0 0 0 0 2 0 0 0 0 0 0 0 0 0 2
2 0 2 0 2 2 2 2 2 2 0 0 0 0 0 0 0 0 0 2
2 0 2 0 0 0 0 0 0 0 0 0 2 2 2 2 2 0 0 2
2 2 2 2 2 2 2 2 2 2 0 0 0 0 0 0 0 0 0 2
2 0 0 0 0 0 0 0 0 0 0 0 0 0 0 0 0 0 0 2
2 0 0 0 0 0 0 0 0 2 0 0 0 0 0 0 0 0 0 2
2 0 0 0 0 0 0 0 0 2 0 0 0 0 0 0 0 0 0 2
2 0 0 0 0 0 0 0 0 2 0 0 0 0 0 0 0 0 0 2
2 0 0 0 0 0 0 0 0 2 0 0 0 0 0 0 0 0 0 2
2 0 0 0 0 0 0 0 0 2 0 0 0 0 0 0 0 0 0 2
2 0 0 0 0 0 0 0 0 2 0 0 0 0 0 0 0 0 0 2
2 0 0 0 0 0 0 0 0 2 0 0 0 0 0 0 0 0 0 2
2 0 0 0 0 0 0 0 0 2 0 0 0 0 0 0 0 0 0 2
2 2 2 2 2 2 2 2 2 2 2 2 2 2 2 2 2 2 2 2



